/Творчество	/
/Творчество/Селски-и-войнишки-хуморески	/tvorchestvo/selski-i-voinishki-humoreski
/Творчество/Селски-и-войнишки-хуморески/За-него-за-войника	/tvorchestvo/selski-i-voinishki-humoreski/za-nego-za-voinika
/Творчество/Селски-и-войнишки-хуморески/Златка	/tvorchestvo/selski-i-voinishki-humoreski/zlatka
/Творчество/Селски-и-войнишки-хуморески/На-нея	/tvorchestvo/selski-i-voinishki-humoreski/na-neya
/Творчество/Селски-и-войнишки-хуморески/По-пътя	/tvorchestvo/selski-i-voinishki-humoreski/po-patya
/Творчество/Селски-и-войнишки-хуморески/Герго-Цветин-писмо-пише	/tvorchestvo/selski-i-voinishki-humoreski/gergo-cvetin-pismo-pishe
/Творчество/Селски-и-войнишки-хуморески/Аскер	/tvorchestvo/selski-i-voinishki-humoreski/asker
/Творчество/Селски-и-войнишки-хуморески/Герговица-Цвета	/tvorchestvo/selski-i-voinishki-humoreski/gergovica-cveta
/Творчество/Селски-и-войнишки-хуморески/Бекярско-дередже	/tvorchestvo/selski-i-voinishki-humoreski/bekyarsko-deredzhe
/Творчество/Селски-и-войнишки-хуморески/Приказка	/tvorchestvo/selski-i-voinishki-humoreski/prikazka
/Творчество/Селски-и-войнишки-хуморески/На-ротния-санитар	/tvorchestvo/selski-i-voinishki-humoreski/na-rotniya-sanitar
/Творчество/Селски-и-войнишки-хуморески/В-готварницата	/tvorchestvo/selski-i-voinishki-humoreski/v-gotvarnicata
/Творчество/Селски-и-войнишки-хуморески/Ангелина	/tvorchestvo/selski-i-voinishki-humoreski/angelina
/Творчество/Селски-и-войнишки-хуморески/Агенция-Партянка	/tvorchestvo/selski-i-voinishki-humoreski/agenciya-partyanka
/Творчество/Селски-и-войнишки-хуморески/Препоръчано-писмо	/tvorchestvo/selski-i-voinishki-humoreski/preporachano-pismo
/Творчество/Селски-и-войнишки-хуморески/Чичовата-Севдалина	/tvorchestvo/selski-i-voinishki-humoreski/chichovata-sevdalina
/Творчество/Селски-и-войнишки-хуморески/Войнишка-любов	/tvorchestvo/selski-i-voinishki-humoreski/voinishka-lyubov
/Творчество/Селски-и-войнишки-хуморески/Военна-картинка	/tvorchestvo/selski-i-voinishki-humoreski/voenna-kartinka
/Творчество/Селски-и-войнишки-хуморески/Войнишка-песен	/tvorchestvo/selski-i-voinishki-humoreski/voinishka-pesen
/Творчество/Селски-и-войнишки-хуморески/Герго-се-обажда	/tvorchestvo/selski-i-voinishki-humoreski/gergo-se-obazhda
/Творчество/Селски-и-войнишки-хуморески/Носталгия	/tvorchestvo/selski-i-voinishki-humoreski/nostalgiya
/Творчество/Селски-и-войнишки-хуморески/Мика	/tvorchestvo/selski-i-voinishki-humoreski/mika
/Творчество/Босилкова-китка	/tvorchestvo/bosilkova-kitka
/Творчество/Босилкова-китка/Две-очи-горят-във-мрака	/tvorchestvo/bosilkova-kitka/dve-ochi-goryat-vav-mraka
/Творчество/Босилкова-китка/Гладен-съм-Ангелино-мари	/tvorchestvo/bosilkova-kitka/gladen-sam-angelino-mari
/Творчество/Босилкова-китка/Късни-нощи-полунощи	/tvorchestvo/bosilkova-kitka/kasni-noshti-polunoshti
/Творчество/Босилкова-китка/Лиляно-девойче-попово	/tvorchestvo/bosilkova-kitka/lilyano-devoiche-popovo
/Творчество/Босилкова-китка/Милкана-девойка	/tvorchestvo/bosilkova-kitka/milkana-devoika
/Творчество/Босилкова-китка/Невясто-млада-Димитрице	/tvorchestvo/bosilkova-kitka/nevyasto-mlada-dimitrice
/Творчество/Босилкова-китка/Млади-момко-хайде-за-малини	/tvorchestvo/bosilkova-kitka/mladi-momko-haide-za-malini
/Творчество/Босилкова-китка/Две-цветарчета-две-дружки	/tvorchestvo/bosilkova-kitka/dve-cvetarcheta-dve-druzhki
/Творчество/Босилкова-китка/На-челце-ти-златни-къдри-се-люлеят	/tvorchestvo/bosilkova-kitka/na-chelce-ti-zlatni-kadri-se-lyuleyat
/Творчество/Босилкова-китка/Звезделино-бяла-гълъбице	/tvorchestvo/bosilkova-kitka/zvezdelino-byala-galabice
/Творчество/Босилкова-китка/С-бял-пешкир-на-шия-шеташ	/tvorchestvo/bosilkova-kitka/s-byal-peshkir-na-shiya-shetash
/Творчество/Босилкова-китка/Малка-мома-змийна-снага-вие	/tvorchestvo/bosilkova-kitka/malka-moma-zmiyna-snaga-vie
/Творчество/Босилкова-китка/Седнала-е-Ружа-мома-хубава	/tvorchestvo/bosilkova-kitka/sednala-e-ruzha-moma-hubava
/Творчество/Босилкова-китка/Мари-моме-тъмнокоса	/tvorchestvo/bosilkova-kitka/mari-mome-tamnokosa
/Творчество/Босилкова-китка/Ще-се-мине-есен-листопада	/tvorchestvo/bosilkova-kitka/shte-se-mine-esen-listopada
/Творчество/Босилкова-китка/Младене-синко-Младене	/tvorchestvo/bosilkova-kitka/mladene-sinko-mladene
/Творчество/Босилкова-китка/Де-гиди-кутли-кавали	/tvorchestvo/bosilkova-kitka/de-gidi-kutli-kavali
/Творчество/Босилкова-китка/Отмина-пролет-цветиста	/tvorchestvo/bosilkova-kitka/otmina-prolet-cvetista
/Творчество/Босилкова-китка/Чакай-ме-чакай-бяла-Марио	/tvorchestvo/bosilkova-kitka/chakai-me-chakai-byala-mario
/Творчество/Босилкова-китка/Малка-мома-галена-Мария	/tvorchestvo/bosilkova-kitka/malka-moma-galena-mariya
/Творчество/Босилкова-китка/Млад-юначина-с-кон-халетина	/tvorchestvo/bosilkova-kitka/mlad-yunachina-s-kon-haletina
/Творчество/Босилкова-китка/Нощ-преваля-златен-месец-гасне	/tvorchestvo/bosilkova-kitka/nosht-prevalya-zlaten-mesec-gasne
/Творчество/Босилкова-китка/Луд-гидия-руйно-вино-пие	/tvorchestvo/bosilkova-kitka/lud-gidiya-ruyno-vino-pie
/Творчество/Босилкова-китка/Снощи-мале-късно-сме-късняли	/tvorchestvo/bosilkova-kitka/snoshti-male-kasno-sme-kasnyali
/Творчество/Босилкова-китка/Петли-пяха-ненке	/tvorchestvo/bosilkova-kitka/petli-pyaha-nenke
/Творчество/Босилкова-китка/Де-гиди-светли-седенки	/tvorchestvo/bosilkova-kitka/de-gidi-svetli-sedenki
/Творчество/Босилкова-китка/Угърчински-нощи	/tvorchestvo/bosilkova-kitka/ugarchinski-noshti
/Творчество/Босилкова-китка/Кой-ще-ви-полива-какини-гиргини	/tvorchestvo/bosilkova-kitka/koi-shte-vi-poliva-kakini-girgini
/Творчество/Босилкова-китка/Повей-ми-ветре-страннико	/tvorchestvo/bosilkova-kitka/povei-mi-vetre-stranniko
/Творчество/Босилкова-китка/Ясно-слънце-грее	/tvorchestvo/bosilkova-kitka/yasno-slance-gree
/Творчество/Босилкова-китка/Девет-дена-слънце-ме-пече	/tvorchestvo/bosilkova-kitka/devet-dena-slance-me-peche
/Творчество/Босилкова-китка/Жътва-жъне-земсова-дружина	/tvorchestvo/bosilkova-kitka/zhatva-zhane-zemsova-druzhina
/Творчество/Босилкова-китка/Сън-ли-беше-тая-буйна-младост	/tvorchestvo/bosilkova-kitka/san-li-beshe-taya-buyna-mladost
/Творчество/Босилкова-китка/Пиле-пее-пиле-песнопойче	/tvorchestvo/bosilkova-kitka/pile-pee-pile-pesnopoiche
/Творчество/Босилкова-китка/Да-бе-ти-либе-мило-за-мене	/tvorchestvo/bosilkova-kitka/da-be-ti-libe-milo-za-mene
/Творчество/Босилкова-китка/Няма-го-войводата	/tvorchestvo/bosilkova-kitka/nyama-go-voivodata
/Творчество/Босилкова-китка/Две-отровни-змии-люто-съскат	/tvorchestvo/bosilkova-kitka/dve-otrovni-zmii-lyuto-saskat
/Творчество/Босилкова-китка/Бяло-зърно-ронят	/tvorchestvo/bosilkova-kitka/byalo-zarno-ronyat
/Творчество/Босилкова-китка/Там-при-моста-на-Огоста	/tvorchestvo/bosilkova-kitka/tam-pri-mosta-na-ogosta
/Творчество/Босилкова-китка/Зора-се-сипва-румена	/tvorchestvo/bosilkova-kitka/zora-se-sipva-rumena
/Творчество/Босилкова-китка/Опустели-мамо-очи-черешови	/tvorchestvo/bosilkova-kitka/opusteli-mamo-ochi-chereshovi
/Творчество/Босилкова-китка/Серафимко-либе-галено	/tvorchestvo/bosilkova-kitka/serafinko-libe-galeno
/Творчество/Босилкова-китка/Пусти-да-са-търми-и-зандани	/tvorchestvo/bosilkova-kitka/pusti-da-se-tarmi-i-zandani
/Творчество/Босилкова-китка/В-твоята-градина-цъвтят-хризантеми	/tvorchestvo/bosilkova-kitka/v-tvoyata-gradina-cavtyat-hrizantemi
/Творчество/Босилкова-китка/Онемяха-момкови-кавали	/tvorchestvo/bosilkova-kitka/onemyaha-momkovi-kavali
/Творчество/Босилкова-китка/Горо-ле-горо-зелена	/tvorchestvo/bosilkova-kitka/goro-le-goro-zelena
/Творчество/Босилкова-китка/Мои-другари-земсови-акрани	/tvorchestvo/bosilkova-kitka/moi-drugari-zemsovi-akrani
/Творчество/Босилкова-китка/Снощи-тъжен-ми-се-върна	/tvorchestvo/bosilkova-kitka/snoshti-tazhen-mi-se-varna
/Творчество/Босилкова-китка/Вест-вестявам-коня-разигравам	/tvorchestvo/bosilkova-kitka/vest-vestyavam-konya-razigravam
/Творчество/Босилкова-китка/Харамийско-либе	/tvorchestvo/bosilkova-kitka/haramiisko-libe
/Творчество/Вик-от-каторгата	/tvorchestvo/vik-ot-katorgata
/Творчество/Вик-от-каторгата/Персин	/tvorchestvo/vik-ot-katorgata/persin
/Творчество/Вик-от-каторгата/Защо	/tvorchestvo/vik-ot-katorgata/zashto
/Творчество/Вик-от-каторгата/На-заточение	/tvorchestvo/vik-ot-katorgata/na-zatochenie
/Творчество/Вик-от-каторгата/Клетва	/tvorchestvo/vik-ot-katorgata/kletva
/Творчество/Вик-от-каторгата/Заключеник	/tvorchestvo/vik-ot-katorgata/zaklyuchenik
/Творчество/Вик-от-каторгата/Жалейно	/tvorchestvo/vik-ot-katorgata/zhaleyno
/Творчество/Вик-от-каторгата/Тъмнична-песен	/tvorchestvo/vik-ot-katorgata/tamnichna-pesen
/Творчество/Вик-от-каторгата/Вик-от-каторгата	/tvorchestvo/vik-ot-katorgata/vik-ot-katorgata
/Творчество/Вик-от-каторгата/Видение	/tvorchestvo/vik-ot-katorgata/videnie
/Творчество/Вик-от-каторгата/Акростих	/tvorchestvo/vik-ot-katorgata/akrostih
/Творчество/Вик-от-каторгата/В-утринния-час	/tvorchestvo/vik-ot-katorgata/v-utrinniya-chas
/Творчество/Вик-от-каторгата/Пролет-в-Персин	/tvorchestvo/vik-ot-katorgata/prolet-v-persin
/Творчество/Вик-от-каторгата/Легенда	/tvorchestvo/vik-ot-katorgata/legenda
/Творчество/Вик-от-каторгата/Повест	/tvorchestvo/vik-ot-katorgata/povest
/Творчество/Вик-от-каторгата/Карцерът	/tvorchestvo/vik-ot-katorgata/karcerat
/Творчество/Вик-от-каторгата/Каторга	/tvorchestvo/vik-ot-katorgata/katorga
/Творчество/Вик-от-каторгата/Колет	/tvorchestvo/vik-ot-katorgata/kolet
/Творчество/Вик-от-каторгата/Робия	/tvorchestvo/vik-ot-katorgata/robiya
/Творчество/Вик-от-каторгата/Затворник	/tvorchestvo/vik-ot-katorgata/zatvornik
/Творчество/Вик-от-каторгата/Утро-в-Персин	/tvorchestvo/vik-ot-katorgata/utro-v-persin
/Творчество/Вик-от-каторгата/Двубой	/tvorchestvo/vik-ot-katorgata/dvuboi
/Творчество/Вик-от-каторгата/Майчина-жалба	/tvorchestvo/vik-ot-katorgata/maychina-zhalba
/Творчество/Вик-от-каторгата/Гълъбчето-бяло	/tvorchestvo/vik-ot-katorgata/galabcheto-byalo
/Творчество/Вик-от-каторгата/Пощенска-картичка	/tvorchestvo/vik-ot-katorgata/poshtenska-kartichka
/Творчество/Вик-от-каторгата/Заклинание	/tvorchestvo/vik-ot-katorgata/zaklinanie
/Творчество/Вик-от-каторгата/Нощ-над-Персин	/tvorchestvo/vik-ot-katorgata/nosht-nad-persin
/Творчество/Вик-от-каторгата/Равносметка	/tvorchestvo/vik-ot-katorgata/ravnosmetka
/Творчество/Вик-от-каторгата/Персински-мотиви	/tvorchestvo/vik-ot-katorgata/persinski-motivi
/Творчество/Вик-от-каторгата/Превъдворяване	/tvorchestvo/vik-ot-katorgata/prevadvoryavane
/Творчество/Вик-от-каторгата/В-часа-на-страшната-раздяла	/tvorchestvo/vik-ot-katorgata/v-chasa-na-strashnata-razdyala
/Творчество/Вик-от-каторгата/Пролет-тъжовна	/tvorchestvo/vik-ot-katorgata/prolet-tazhovna
/Творчество/Разпилени-пъстроцветия	/tvorchestvo/razpileni-pastrotsvetiya
/Творчество/Разпилени-пъстроцветия/Изповедно	/tvorchestvo/razpileni-pastrotsvetiya/izpovedno
/Творчество/Разпилени-пъстроцветия/Светая-светих	/tvorchestvo/razpileni-pastrotsvetiya/svetaya-svetih
/Творчество/Разпилени-пъстроцветия/Скръбна-песен	/tvorchestvo/razpileni-pastrotsvetiya/skrabna-pesen
/Творчество/Разпилени-пъстроцветия/Равносметка	/tvorchestvo/razpileni-pastrotsvetiya/ravnosmetka
/Творчество/Разпилени-пъстроцветия/Защо-мълчим	/tvorchestvo/razpileni-pastrotsvetiya/zashto-malchim
/Творчество/Разпилени-пъстроцветия/Човекът	/tvorchestvo/razpileni-pastrotsvetiya/chovekat
/Творчество/Разпилени-пъстроцветия/Защо-не-пишеш	/tvorchestvo/razpileni-pastrotsvetiya/zashto-ne-pishesh
/Творчество/Разпилени-пъстроцветия/Към-поета	/tvorchestvo/razpileni-pastrotsvetiya/kam-poeta
/Творчество/Разпилени-пъстроцветия/До-сетен-час	/tvorchestvo/razpileni-pastrotsvetiya/do-seten-chas
/Творчество/Разпилени-пъстроцветия/Елегия	/tvorchestvo/razpileni-pastrotsvetiya/elegiya
/Творчество/Разпилени-пъстроцветия/Народ	/tvorchestvo/razpileni-pastrotsvetiya/narod
/Творчество/Разпилени-пъстроцветия/Борба	/tvorchestvo/razpileni-pastrotsvetiya/borba
/Творчество/Разпилени-пъстроцветия/Сталин	/tvorchestvo/razpileni-pastrotsvetiya/stalin
/Творчество/Разпилени-пъстроцветия/Пред-буря	/tvorchestvo/razpileni-pastrotsvetiya/pred-burya
/Творчество/Разпилени-пъстроцветия/Съдба	/tvorchestvo/razpileni-pastrotsvetiya/sadba
/Творчество/Разпилени-пъстроцветия/SOS	/tvorchestvo/razpileni-pastrotsvetiya/sos
/Творчество/Разпилени-пъстроцветия/Великден	/tvorchestvo/razpileni-pastrotsvetiya/velikden
/Творчество/Разпилени-пъстроцветия/Поетът	/tvorchestvo/razpileni-pastrotsvetiya/poetat
/Творчество/Разпилени-пъстроцветия/Революцийо	/tvorchestvo/razpileni-pastrotsvetiya/revolyuciyo
/Творчество/Разпилени-пъстроцветия/Потоп	/tvorchestvo/razpileni-pastrotsvetiya/potop
/Творчество/Разпилени-пъстроцветия/Pro-domo-sua	/tvorchestvo/razpileni-pastrotsvetiya/pro-domo-sua
/Творчество/Разпилени-пъстроцветия/В-Дряновския-манастир	/tvorchestvo/razpileni-pastrotsvetiya/v-dryanovskiya-manastir
/Творчество/Разпилени-пъстроцветия/Песен-за-родния-край	/tvorchestvo/razpileni-pastrotsvetiya/pesen-za-rodniya-krai
/Творчество/Разпилени-пъстроцветия/Човекът-е-роден-за-полет	/tvorchestvo/razpileni-pastrotsvetiya/chovekat-e-roden-za-polet
/Творчество/Разпилени-пъстроцветия/Огън-е-потребен	/tvorchestvo/razpileni-pastrotsvetiya/ogan-e-potreben
/Творчество/Разпилени-пъстроцветия/Небето-с-плам-ме-е-дарило	/tvorchestvo/razpileni-pastrotsvetiya/nebeto-s-plam-me-e-darilo
/Творчество/Разпилени-пъстроцветия/Всеки-иска-да-векува	/tvorchestvo/razpileni-pastrotsvetiya/vseki-iska-da-vekuva
/Творчество/Разпилени-пъстроцветия/Привечер	/tvorchestvo/razpileni-pastrotsvetiya/privecher
/Творчество/Разпилени-пъстроцветия/АЕЦ	/tvorchestvo/razpileni-pastrotsvetiya/aec
/Творчество/Разпилени-пъстроцветия/Свиден-спомен	/tvorchestvo/razpileni-pastrotsvetiya/sviden-spomen
/Творчество/Разпилени-пъстроцветия/Аз-казах-вече-на-света	/tvorchestvo/razpileni-pastrotsvetiya/az-kazah-veche-na-sveta
/Творчество/Разпилени-пъстроцветия/Старост	/tvorchestvo/razpileni-pastrotsvetiya/starost
/Творчество/Разпилени-пъстроцветия/Богатство	/tvorchestvo/razpileni-pastrotsvetiya/bogatstvo
/Творчество/Разпилени-пъстроцветия/Предсмъртно	/tvorchestvo/razpileni-pastrotsvetiya/predsmartno
/Творчество/Разпилени-пъстроцветия/Месия	/tvorchestvo/razpileni-pastrotsvetiya/mesiya
/Творчество/Разпилени-пъстроцветия/Човеколюбецът	/tvorchestvo/razpileni-pastrotsvetiya/chovekolyubecat
/Творчество/Разпилени-пъстроцветия/Стоикът	/tvorchestvo/razpileni-pastrotsvetiya/stoikat
/Творчество/Разпилени-пъстроцветия/Непобеденият	/tvorchestvo/razpileni-pastrotsvetiya/nepobedeniyat
/Творчество/Разпилени-пъстроцветия/Реквием	/tvorchestvo/razpileni-pastrotsvetiya/rekviem
/Творчество/Разпилени-пъстроцветия/Раздяла	/tvorchestvo/razpileni-pastrotsvetiya/razdyala
/Творчество/Разпилени-пъстроцветия/In-memoriam	/tvorchestvo/razpileni-pastrotsvetiya/in-memoriam
/Творчество/Разпилени-пъстроцветия/На-птиците-завиждам-аз	/tvorchestvo/razpileni-pastrotsvetiya/na-pticite-zavizhdam-az
/Творчество/Разпилени-пъстроцветия/В-здрачен-час	/tvorchestvo/razpileni-pastrotsvetiya/v-zdrachen-chas
/Творчество/Разпилени-пъстроцветия/След-Интервю-с-Би-Би-Си	/tvorchestvo/razpileni-pastrotsvetiya/sled-intervyu-s-bbc
/Творчество/Разпилени-пъстроцветия/Яворови-дни	/tvorchestvo/razpileni-pastrotsvetiya/yavorovi-dni
/Творчество/Разпилени-пъстроцветия/На-твоя-гроб	/tvorchestvo/razpileni-pastrotsvetiya/na-tvoya-grob
/Творчество/Разпилени-пъстроцветия/Жрицата	/tvorchestvo/razpileni-pastrotsvetiya/zhricata
/Творчество/Разпилени-пъстроцветия/Надгробно	/tvorchestvo/razpileni-pastrotsvetiya/nadgrobno
/Творчество/Разпилени-пъстроцветия/Гълъби	/tvorchestvo/razpileni-pastrotsvetiya/galabi
/Творчество/Разпилени-пъстроцветия/Врабче	/tvorchestvo/razpileni-pastrotsvetiya/vrabche
/Творчество/Разпилени-пъстроцветия/Елхичката	/tvorchestvo/razpileni-pastrotsvetiya/elhichkata
/Творчество/Разпилени-пъстроцветия/Мила-моя-бабо	/tvorchestvo/razpileni-pastrotsvetiya/mila-moya-babo
/Творчество/Разпилени-пъстроцветия/Учителят	/tvorchestvo/razpileni-pastrotsvetiya/uchitelyat
/Творчество/Разпилени-пъстроцветия/На-моя-техникум	/tvorchestvo/razpileni-pastrotsvetiya/na-moya-tehnikum
/Творчество/Разпилени-пъстроцветия/Юбилейно	/tvorchestvo/razpileni-pastrotsvetiya/yubileino
/Творчество/Разпилени-пъстроцветия/На-моето-училище	/tvorchestvo/razpileni-pastrotsvetiya/na-moeto-uchilishte
/Творчество/Разпилени-пъстроцветия/Сбогом	/tvorchestvo/razpileni-pastrotsvetiya/sbogom
/Творчество/Разпилени-пъстроцветия/Прощално	/tvorchestvo/razpileni-pastrotsvetiya/proshtalno
/Творчество/Разпилени-пъстроцветия/В-Ялта	/tvorchestvo/razpileni-pastrotsvetiya/v-yalta
/Творчество/Разпилени-пъстроцветия/Също-като-в-нас	/tvorchestvo/razpileni-pastrotsvetiya/sashto-kato-v-nas
/Творчество/Разпилени-пъстроцветия/Кримска-балада	/tvorchestvo/razpileni-pastrotsvetiya/krimska-balada
/Творчество/Разпилени-пъстроцветия/В-къщата-музей-на-Чехов	/tvorchestvo/razpileni-pastrotsvetiya/v-kashtata-muzei-na-chehov
/Творчество/Разпилени-пъстроцветия/В-Бахчи-сарай	/tvorchestvo/razpileni-pastrotsvetiya/v-bahchi-sarai
/Творчество/Разпилени-пъстроцветия/Към-морето	/tvorchestvo/razpileni-pastrotsvetiya/kam-moreto
/Творчество/Разпилени-пъстроцветия/В-такава-нощ-незабравима	/tvorchestvo/razpileni-pastrotsvetiya/v-takava-nosht-nezabravima
/Творчество/Разпилени-пъстроцветия/Романтика	/tvorchestvo/razpileni-pastrotsvetiya/romantika
/Творчество/Разпилени-пъстроцветия/Довиждане-мой-черноморски-бряг	/tvorchestvo/razpileni-pastrotsvetiya/dovizhdane-moi-chernomorski-bryag
/Творчество/Разпилени-пъстроцветия/По-Дунава	/tvorchestvo/razpileni-pastrotsvetiya/po-dunava
/Творчество/Разпилени-пъстроцветия/И-тази-вечер	/tvorchestvo/razpileni-pastrotsvetiya/i-tazi-vecher
/Творчество/Разпилени-пъстроцветия/В-този-безпределно-хубав-свят	/tvorchestvo/razpileni-pastrotsvetiya/v-tozi-bezpredelno-hubav-svyat
/Творчество/Разпилени-пъстроцветия/Песен	/tvorchestvo/razpileni-pastrotsvetiya/pesen
/Творчество/Разпилени-пъстроцветия/Вечерна-среща	/tvorchestvo/razpileni-pastrotsvetiya/vecherna-sreshta
/Творчество/Разпилени-пъстроцветия/Антонина	/tvorchestvo/razpileni-pastrotsvetiya/antonina
/Творчество/Разпилени-пъстроцветия/Ти-помниш-ли-Меглена	/tvorchestvo/razpileni-pastrotsvetiya/ti-pomnish-li-meglena
/Творчество/Разпилени-пъстроцветия/Жулиета	/tvorchestvo/razpileni-pastrotsvetiya/zhulieta
/Творчество/Разпилени-пъстроцветия/Благодаря-ти-Мариета	/tvorchestvo/razpileni-pastrotsvetiya/blagodarya-ti-marieta
/Творчество/Разпилени-пъстроцветия/Четвърта-нощ	/tvorchestvo/razpileni-pastrotsvetiya/chetvarta-nosht
/Творчество/Разпилени-пъстроцветия/Писмо	/tvorchestvo/razpileni-pastrotsvetiya/pismo
/Творчество/Разпилени-пъстроцветия/Недей-тъгува	/tvorchestvo/razpileni-pastrotsvetiya/nedei-taguva
/Творчество/Разпилени-пъстроцветия/Венец-от-незабравки	/tvorchestvo/razpileni-pastrotsvetiya/venec-ot-nezabravki
/Творчество/Ти-ли-ме-повика-мое-родно-село	/tvorchestvo/ti-li-me-povika-moe-rodno-selo
/Творчество/Ти-ли-ме-повика-мое-родно-село/Синът	/tvorchestvo/ti-li-me-povika-moe-rodno-selo/sinat
/Творчество/Ти-ли-ме-повика-мое-родно-село/Утринна-песен	/tvorchestvo/ti-li-me-povika-moe-rodno-selo/utrinna-pesen
/Творчество/Ти-ли-ме-повика-мое-родно-село/Пролетна-песен	/tvorchestvo/ti-li-me-povika-moe-rodno-selo/proletna-pesen
/Творчество/Ти-ли-ме-повика-мое-родно-село/Майско-утро	/tvorchestvo/ti-li-me-povika-moe-rodno-selo/maisko-utro
/Творчество/Ти-ли-ме-повика-мое-родно-село/Пролетен-химн	/tvorchestvo/ti-li-me-povika-moe-rodno-selo/proleten-himn
/Творчество/Ти-ли-ме-повика-мое-родно-село/Пролетно-опиянение	/tvorchestvo/ti-li-me-povika-moe-rodno-selo/proletno-opiyanenie
/Творчество/Ти-ли-ме-повика-мое-родно-село/Химн-на-селските-кооператори	/tvorchestvo/ti-li-me-povika-moe-rodno-selo/himn-na-selskite-kooperatori
/Творчество/Ти-ли-ме-повика-мое-родно-село/Хубава-си-българска-земя	/tvorchestvo/ti-li-me-povika-moe-rodno-selo/hubava-si-balgarska-zemya
/Творчество/Ти-ли-ме-повика-мое-родно-село/Утро	/tvorchestvo/ti-li-me-povika-moe-rodno-selo/utro
/Творчество/Ти-ли-ме-повика-мое-родно-село/Сред-житата	/tvorchestvo/ti-li-me-povika-moe-rodno-selo/sred-zhitata
/Творчество/Ти-ли-ме-повика-мое-родно-село/Вечерно	/tvorchestvo/ti-li-me-povika-moe-rodno-selo/vecherno
/Творчество/Ти-ли-ме-повика-мое-родно-село/Лятна-нощ	/tvorchestvo/ti-li-me-povika-moe-rodno-selo/lyatna-nosht
/Творчество/Ти-ли-ме-повика-мое-родно-село/Коситба	/tvorchestvo/ti-li-me-povika-moe-rodno-selo/kositba
/Творчество/Ти-ли-ме-повика-мое-родно-село/Конници	/tvorchestvo/ti-li-me-povika-moe-rodno-selo/konnici
/Творчество/Ти-ли-ме-повика-мое-родно-село/Акрани	/tvorchestvo/ti-li-me-povika-moe-rodno-selo/akrani
/Творчество/Ти-ли-ме-повика-мое-родно-село/Старият-златар	/tvorchestvo/ti-li-me-povika-moe-rodno-selo/stariyat-zlatar
/Творчество/Ти-ли-ме-повика-мое-родно-село/Ноктюрно	/tvorchestvo/ti-li-me-povika-moe-rodno-selo/noktyurno
/Творчество/Ти-ли-ме-повика-мое-родно-село/Завръщане	/tvorchestvo/ti-li-me-povika-moe-rodno-selo/zavrashtane
/Творчество/Ти-ли-ме-повика-мое-родно-село/Тополите	/tvorchestvo/ti-li-me-povika-moe-rodno-selo/topolite
/Творчество/Ти-ли-ме-повика-мое-родно-село/Спомен-за-мама	/tvorchestvo/ti-li-me-povika-moe-rodno-selo/spomen-za-mama
/Творчество/Ти-ли-ме-повика-мое-родно-село/Приказка-са-мамините-думи	/tvorchestvo/ti-li-me-povika-moe-rodno-selo/prikazka-sa-maminite-dumi
/Творчество/Ти-ли-ме-повика-мое-родно-село/Тъга-по-Чирен	/tvorchestvo/ti-li-me-povika-moe-rodno-selo/taga-po-chiren
/Творчество/Ти-ли-ме-повика-мое-родно-село/Орач	/tvorchestvo/ti-li-me-povika-moe-rodno-selo/orach
/Творчество/Ти-ли-ме-повика-мое-родно-село/Лято	/tvorchestvo/ti-li-me-povika-moe-rodno-selo/lyato
/Творчество/Ти-ли-ме-повика-мое-родно-село/След-пладне	/tvorchestvo/ti-li-me-povika-moe-rodno-selo/sled-pladne
/Творчество/Ти-ли-ме-повика-мое-родно-село/Селска-неволя	/tvorchestvo/ti-li-me-povika-moe-rodno-selo/selska-nevolya
/Творчество/Ти-ли-ме-повика-мое-родно-село/Село	/tvorchestvo/ti-li-me-povika-moe-rodno-selo/selo
/Творчество/Ти-ли-ме-повика-мое-родно-село/Към-село	/tvorchestvo/ti-li-me-povika-moe-rodno-selo/kam-selo
/Творчество/Ти-ли-ме-повика-мое-родно-село/Зима-в-нашенско	/tvorchestvo/ti-li-me-povika-moe-rodno-selo/zima-v-nashensko
/Творчество/Ти-ли-ме-повика-мое-родно-село/Бъдни-вечер	/tvorchestvo/ti-li-me-povika-moe-rodno-selo/badni-vecher
/Творчество/Ти-ли-ме-повика-мое-родно-село/Очакваната	/tvorchestvo/ti-li-me-povika-moe-rodno-selo/ochakvanata
/Творчество/Ти-ли-ме-повика-мое-родно-село/Певачка	/tvorchestvo/ti-li-me-povika-moe-rodno-selo/pevachka
/Творчество/Ти-ли-ме-повика-мое-родно-село/Вършитба	/tvorchestvo/ti-li-me-povika-moe-rodno-selo/varshitba
/Творчество/Ти-ли-ме-повика-мое-родно-село/В-бащиния-дом	/tvorchestvo/ti-li-me-povika-moe-rodno-selo/v-bashtiniya-dom
/Творчество/Ти-ли-ме-повика-мое-родно-село/Великанът	/tvorchestvo/ti-li-me-povika-moe-rodno-selo/velikanat
/Творчество/Ти-ли-ме-повика-мое-родно-село/Републиканецът	/tvorchestvo/ti-li-me-povika-moe-rodno-selo/republikanecat
/Творчество/Ти-ли-ме-повика-мое-родно-село/Първоапостолът	/tvorchestvo/ti-li-me-povika-moe-rodno-selo/parvoapostolat
/Творчество/Ти-ли-ме-повика-мое-родно-село/Железният	/tvorchestvo/ti-li-me-povika-moe-rodno-selo/zhelezniyat
/Творчество/Ти-ли-ме-повика-мое-родно-село/Несломимият	/tvorchestvo/ti-li-me-povika-moe-rodno-selo/neslomimiyat
/Творчество/Ти-ли-ме-повика-мое-родно-село/Закрилникът	/tvorchestvo/ti-li-me-povika-moe-rodno-selo/zakrilnikat
/Творчество/Ти-ли-ме-повика-мое-родно-село/Ангелогласният	/tvorchestvo/ti-li-me-povika-moe-rodno-selo/angeloglasniyat
/Творчество/Ти-ли-ме-повика-мое-родно-село/Душмани-трифон-затюрмиха	/tvorchestvo/ti-li-me-povika-moe-rodno-selo/dushmani-trifon-zatyurmiha
/Творчество/Ти-ли-ме-повика-мое-родно-село/Приказка	/tvorchestvo/ti-li-me-povika-moe-rodno-selo/prikazka
/Творчество/Ти-ли-ме-повика-мое-родно-село/Април-1925	/tvorchestvo/ti-li-me-povika-moe-rodno-selo/april-1925
/Творчество/Ти-ли-ме-повика-мое-родно-село/Из-Хайдушки-песни	/tvorchestvo/ti-li-me-povika-moe-rodno-selo/iz-haydushki-pesni
/Творчество/Ти-ли-ме-повика-мое-родно-село/Момина-жалба	/tvorchestvo/ti-li-me-povika-moe-rodno-selo/momina-zhalba
/Творчество/Ти-ли-ме-повика-мое-родно-село/Тъжна-песен	/tvorchestvo/ti-li-me-povika-moe-rodno-selo/tazhna-pesen
/Творчество/Ти-ли-ме-повика-мое-родно-село/Серафимке-либе-галено	/tvorchestvo/ti-li-me-povika-moe-rodno-selo/serafimke-libe-galeno
/Творчество/Ти-ли-ме-повика-мое-родно-село/Косачи	/tvorchestvo/ti-li-me-povika-moe-rodno-selo/kosachi
/Творчество/Ти-ли-ме-повика-мое-родно-село/Пусто-жребе	/tvorchestvo/ti-li-me-povika-moe-rodno-selo/pusto-zhrebe
/Творчество/Ти-ли-ме-повика-мое-родно-село/Среща	/tvorchestvo/ti-li-me-povika-moe-rodno-selo/sreshta
/Творчество/Ти-ли-ме-повика-мое-родно-село/Харамии	/tvorchestvo/ti-li-me-povika-moe-rodno-selo/haramii
/Творчество/Ти-ли-ме-повика-мое-родно-село/Шабла-дуранкулак	/tvorchestvo/ti-li-me-povika-moe-rodno-selo/shabla-durankulak
/Творчество/Ти-ли-ме-повика-мое-родно-село/Ангелина	/tvorchestvo/ti-li-me-povika-moe-rodno-selo/angelina
/Творчество/Ти-ли-ме-повика-мое-родно-село/Янка	/tvorchestvo/ti-li-me-povika-moe-rodno-selo/yanka
/Творчество/Ти-ли-ме-повика-мое-родно-село/Имам-конче-шарколия	/tvorchestvo/ti-li-me-povika-moe-rodno-selo/imam-konche-sharkoliya
/Творчество/Ти-ли-ме-повика-мое-родно-село/Земляци	/tvorchestvo/ti-li-me-povika-moe-rodno-selo/zemlyaci
/Творчество/Ти-ли-ме-повика-мое-родно-село/По-пътя	/tvorchestvo/ti-li-me-povika-moe-rodno-selo/po-patya
/Творчество/Ти-ли-ме-повика-мое-родно-село/Обикновена-случка	/tvorchestvo/ti-li-me-povika-moe-rodno-selo/obiknovena-sluchka
/Творчество/Ти-ли-ме-повика-мое-родно-село/Господи-помилуй-нас	/tvorchestvo/ti-li-me-povika-moe-rodno-selo/gospodi-pomilui-nas
/Творчество/Ти-ли-ме-повика-мое-родно-село/Из-младини	/tvorchestvo/ti-li-me-povika-moe-rodno-selo/iz-mladini
/Творчество/Ти-ли-ме-повика-мое-родно-село/Из-седенкарски-песни	/tvorchestvo/ti-li-me-povika-moe-rodno-selo/iz-sedenkarski-pesni
/Творчество/Ти-ли-ме-повика-мое-родно-село/Из-жетварски-песни	/tvorchestvo/ti-li-me-povika-moe-rodno-selo/iz-zhetvarski-pesni
/Творчество/Ти-ли-ме-повика-мое-родно-село/Из-харамийско-либе	/tvorchestvo/ti-li-me-povika-moe-rodno-selo/iz-haramiisko-libe
/Творчество/Ти-ли-ме-повика-мое-родно-село/Угърчински-нощи	/tvorchestvo/ti-li-me-povika-moe-rodno-selo/ugarchinski-noshti
/Творчество/Смях-и-жлъч	/tvorchestvo/smyah-i-zhlach
/Творчество/Смях-и-жлъч/Диктатори	/tvorchestvo/smyah-i-zhlach/diktatorat
/Творчество/Смях-и-жлъч/Селякът	/tvorchestvo/smyah-i-zhlach/selyakot
/Творчество/Смях-и-жлъч/Новият-човек	/tvorchestvo/smyah-i-zhlach/noviqt-chovek
/Творчество/Смях-и-жлъч/Вълци	/tvorchestvo/smyah-i-zhlach/valci
/Творчество/Смях-и-жлъч/На-един-людоед	/tvorchestvo/smyah-i-zhlach/na-edin-lyudoed
/Творчество/Смях-и-жлъч/Кой-е-днес-на-власт-у-нас	/tvorchestvo/smyah-i-zhlach/koi-e-dnes-na-vlast-u-nas
/Творчество/Смях-и-жлъч/Двамата	/tvorchestvo/smyah-i-zhlach/dvamata
/Творчество/Смях-и-жлъч/Юбилей	/tvorchestvo/smyah-i-zhlach/yubilei
/Творчество/Смях-и-жлъч/Прокълнатият	/tvorchestvo/smyah-i-zhlach/prokalnatiyat
/Творчество/Смях-и-жлъч/Активните-борци	/tvorchestvo/smyah-i-zhlach/aktivnite-borci
/Творчество/Смях-и-жлъч/Скрита-картинка	/tvorchestvo/smyah-i-zhlach/skrita-kartinka
/Творчество/Смях-и-жлъч/Заветът-на-Ленин	/tvorchestvo/smyah-i-zhlach/zavetat-na-lenin
/Творчество/Смях-и-жлъч/На-Вазовия-гроб	/tvorchestvo/smyah-i-zhlach/na-vazoviya-grob
/Творчество/Смях-и-жлъч/За-благодарност	/tvorchestvo/smyah-i-zhlach/za-blagodarnost
/Творчество/Смях-и-жлъч/Създание	/tvorchestvo/smyah-i-zhlach/sazdanie
/Творчество/Смях-и-жлъч/Плюй-и-отмини	/tvorchestvo/smyah-i-zhlach/plyui-i-otmini
/Творчество/Смях-и-жлъч/Честване	/tvorchestvo/smyah-i-zhlach/chestvane
/Творчество/Смях-и-жлъч/Изповед	/tvorchestvo/smyah-i-zhlach/izpoved
/Творчество/Смях-и-жлъч/Луд	/tvorchestvo/smyah-i-zhlach/lud
/Творчество/Смях-и-жлъч/Талмудисти	/tvorchestvo/smyah-i-zhlach/talmudisti
/Творчество/Смях-и-жлъч/Все-тези	/tvorchestvo/smyah-i-zhlach/vse-tezi
/Творчество/Смях-и-жлъч/Родна-картинка	/tvorchestvo/smyah-i-zhlach/rodna-kartinka
/Творчество/Смях-и-жлъч/Възмездие	/tvorchestvo/smyah-i-zhlach/vazmezdie
/Творчество/Смях-и-жлъч/Проклятие	/tvorchestvo/smyah-i-zhlach/proklyatie
/Творчество/Смях-и-жлъч/Житен-клас	/tvorchestvo/smyah-i-zhlach/zhiten-klas
/Творчество/Смях-и-жлъч/На-Хитлера-благодарете	/tvorchestvo/smyah-i-zhlach/na-hitlera-blagodarete
/Творчество/Смях-и-жлъч/Затвор	/tvorchestvo/smyah-i-zhlach/zatvor
/Творчество/Смях-и-жлъч/Псалмопевци	/tvorchestvo/smyah-i-zhlach/psalmopevci
/Творчество/Смях-и-жлъч/Ний-народ-сме-поетичен	/tvorchestvo/smyah-i-zhlach/nii-narod-sme-poetichen
/Творчество/Смях-и-жлъч/Реплика	/tvorchestvo/smyah-i-zhlach/replika
/Творчество/Смях-и-жлъч/Поети	/tvorchestvo/smyah-i-zhlach/poeti
/Творчество/Смях-и-жлъч/Просъница	/tvorchestvo/smyah-i-zhlach/prosanica
/Творчество/Смях-и-жлъч/Автор-и-герой	/tvorchestvo/smyah-i-zhlach/avtor-i-geroi
/Творчество/Смях-и-жлъч/Бъдещ-писател	/tvorchestvo/smyah-i-zhlach/badesht-pisatel
/Творчество/Смях-и-жлъч/Писател	/tvorchestvo/smyah-i-zhlach/pisatel
/Творчество/Смях-и-жлъч/Писателският-съюз	/tvorchestvo/smyah-i-zhlach/pisatelskiyat-sayuz
/Творчество/Смях-и-жлъч/Докато-съм-жив	/tvorchestvo/smyah-i-zhlach/dokato-sam-zhiv
/Творчество/Смях-и-жлъч/Девизът	/tvorchestvo/smyah-i-zhlach/devizat
/Творчество/Смях-и-жлъч/Погребално	/tvorchestvo/smyah-i-zhlach/pogrebalno
/Творчество/Смях-и-жлъч/Послание-до-професора-по-финансова-наука-Петко-Стоянов	/tvorchestvo/smyah-i-zhlach/poslanie-do-profesora-po-finansova-nauka-petko-stoyanov
/Творчество/Смях-и-жлъч/Завод	/tvorchestvo/smyah-i-zhlach/zavod
/Творчество/Смях-и-жлъч/Мента	/tvorchestvo/smyah-i-zhlach/menta
/Творчество/Смях-и-жлъч/Сказание	/tvorchestvo/smyah-i-zhlach/skazanie
/Творчество/Смях-и-жлъч/В-трамвая	/tvorchestvo/smyah-i-zhlach/v-tramvaya
/Творчество/Смях-и-жлъч/Един-от-многото-нашенци	/tvorchestvo/smyah-i-zhlach/edin-ot-mnogoto-nashenci
/Творчество/Смях-и-жлъч/Честито	/tvorchestvo/smyah-i-zhlach/chestito
/Творчество/Смях-и-жлъч/Стара-мъдрост	/tvorchestvo/smyah-i-zhlach/stara-madrost
/Творчество/Смях-и-жлъч/Уж-сме-правова-държава	/tvorchestvo/smyah-i-zhlach/uzh-sme-pravova-darzhava
/Творчество/Смях-и-жлъч/Автори	/tvorchestvo/smyah-i-zhlach/avtori
/Творчество/Смях-и-жлъч/Налъми	/tvorchestvo/smyah-i-zhlach/nalami
/Творчество/Смях-и-жлъч/Хора	/tvorchestvo/smyah-i-zhlach/hora
/Творчество/Смях-и-жлъч/ОФ-Събрание	/tvorchestvo/smyah-i-zhlach/of-sabranie
/Творчество/Смях-и-жлъч/Посмещище	/tvorchestvo/smyah-i-zhlach/posmeshishte
/Творчество/Смях-и-жлъч/На-един-нашенец	/tvorchestvo/smyah-i-zhlach/na-edin-nashenec
/Творчество/Смях-и-жлъч/Кариера	/tvorchestvo/smyah-i-zhlach/kariera
/Творчество/Смях-и-жлъч/Целебна-сила	/tvorchestvo/smyah-i-zhlach/celebna-sila
/Творчество/Смях-и-жлъч/Пророкуване	/tvorchestvo/smyah-i-zhlach/prorokuvane
/Творчество/Смях-и-жлъч/Приветствие	/tvorchestvo/smyah-i-zhlach/privetstvie
/Творчество/Смях-и-жлъч/Пенсионерска	/tvorchestvo/smyah-i-zhlach/pensionerska
/Творчество/Смях-и-жлъч/Заходляк	/tvorchestvo/smyah-i-zhlach/zahodlyak
/Творчество/Смях-и-жлъч/Златната-кука	/tvorchestvo/smyah-i-zhlach/zlatnata-kuka
/Творчество/Смях-и-жлъч/При-почерпка	/tvorchestvo/smyah-i-zhlach/pri-pocherpka
/Творчество/Смях-и-жлъч/Към-Балчик	/tvorchestvo/smyah-i-zhlach/kam-balchik
/Творчество/Смях-и-жлъч/Балчик	/tvorchestvo/smyah-i-zhlach/balchik
/Творчество/Смях-и-жлъч/Елена	/tvorchestvo/smyah-i-zhlach/elena
/Творчество/Смях-и-жлъч/Кончина	/tvorchestvo/smyah-i-zhlach/konchina
/Творчество/Смях-и-жлъч/За-шкембето-и-за-свинските-черва	/tvorchestvo/smyah-i-zhlach/za-shkembeto-i-svinskite-cherva
/Творчество/Смях-и-жлъч/Дръвчето	/tvorchestvo/smyah-i-zhlach/dravcheto
/Творчество/Смях-и-жлъч/Шегобийците-пазете	/tvorchestvo/smyah-i-zhlach/shegobiicite-pazete
/Творчество/Смях-и-жлъч/Благодаря	/tvorchestvo/smyah-i-zhlach/blagodarya
/Творчество/Смях-и-жлъч/Жената	/tvorchestvo/smyah-i-zhlach/zhenata
/Творчество/Смях-и-жлъч/Майско-утро	/tvorchestvo/smyah-i-zhlach/maisko-utro
/Творчество/Смях-и-жлъч/Простакът	/tvorchestvo/smyah-i-zhlach/prostakat
/Творчество/Смях-и-жлъч/Защо-ти-трябваше-Исусе	/tvorchestvo/smyah-i-zhlach/zashto-ti-tryabvashe-isuse
/Творчество/Смях-и-жлъч/Безсмъртният	/tvorchestvo/smyah-i-zhlach/bezsmartniyat
/Творчество/Декамеронки-като-бонбонки	/tvorchestvo/dekameronki-kato-bonbonki
/Творчество/Декамеронки-като-бонбонки/Жени-жени	/tvorchestvo/dekameronki-kato-bonbonki/zheni-zheni
/Творчество/Декамеронки-като-бонбонки/Златната-кука	/tvorchestvo/dekameronki-kato-bonbonki/zlatnata-kuka
/Творчество/Декамеронки-като-бонбонки/Жената	/tvorchestvo/dekameronki-kato-bonbonki/zhenata
/Творчество/Декамеронки-като-бонбонки/Богатство	/tvorchestvo/dekameronki-kato-bonbonki/bogatstvo
/Творчество/Декамеронки-като-бонбонки/Майско-утро	/tvorchestvo/dekameronki-kato-bonbonki/maisko-utro
/Творчество/Декамеронки-като-бонбонки/Елена	/tvorchestvo/dekameronki-kato-bonbonki/elena
/Творчество/Декамеронки-като-бонбонки/Жулиета	/tvorchestvo/dekameronki-kato-bonbonki/zhulieta
/Творчество/Декамеронки-като-бонбонки/Янка	/tvorchestvo/dekameronki-kato-bonbonki/yanka
/Творчество/Декамеронки-като-бонбонки/Имам-конче-шарколия	/tvorchestvo/dekameronki-kato-bonbonki/imam-konche-sharkoliya
/Творчество/Декамеронки-като-бонбонки/Благодаря-ти-Мариета	/tvorchestvo/dekameronki-kato-bonbonki/blagodarya-ti-marieta
/Творчество/Декамеронки-като-бонбонки/Пенсионерска	/tvorchestvo/dekameronki-kato-bonbonki/pensionerska
/Творчество/Декамеронки-като-бонбонки/Кариера	/tvorchestvo/dekameronki-kato-bonbonki/kariera
/Творчество/Декамеронки-като-бонбонки/Молитва	/tvorchestvo/dekameronki-kato-bonbonki/molitva
/Творчество/Декамеронки-като-бонбонки/Блага-рана	/tvorchestvo/dekameronki-kato-bonbonki/blaga-rana
/Творчество/Декамеронки-като-бонбонки/Стара-мъдрост	/tvorchestvo/dekameronki-kato-bonbonki/stara-madrost
/Творчество/Декамеронки-като-бонбонки/Всеки-иска-да-векува	/tvorchestvo/dekameronki-kato-bonbonki/vseki-iska-da-vekuva
/Творчество/Декамеронки-като-бонбонки/Мария	/tvorchestvo/dekameronki-kato-bonbonki/mariya
/Творчество/Декамеронки-като-бонбонки/Кончина	/tvorchestvo/dekameronki-kato-bonbonki/konchina
/Творчество/Декамеронки-като-бонбонки/Войнишка-любов	/tvorchestvo/dekameronki-kato-bonbonki/voinishka-lyubov
/Творчество/Декамеронки-като-бонбонки/Целебна-сила	/tvorchestvo/dekameronki-kato-bonbonki/celebna-sila
/Творчество/Декамеронки-като-бонбонки/Вечерна-среща	/tvorchestvo/dekameronki-kato-bonbonki/vecherna-sreshta
/Творчество/Декамеронки-като-бонбонки/Всяка-възраст	/tvorchestvo/dekameronki-kato-bonbonki/vsyaka-vazrast
/Творчество/Декамеронки-като-бонбонки/Майтап	/tvorchestvo/dekameronki-kato-bonbonki/maitap
/Творчество/Декамеронки-като-бонбонки/С-благодарност	/tvorchestvo/dekameronki-kato-bonbonki/s-blagodarnost
/Творчество/Декамеронки-като-бонбонки/Смърт-и-старост	/tvorchestvo/dekameronki-kato-bonbonki/smart-i-starost
/Творчество/Декамеронки-като-бонбонки/Ти-и-аз	/tvorchestvo/dekameronki-kato-bonbonki/ti-i-az
/Творчество/Декамеронки-като-бонбонки/Мечтаната	/tvorchestvo/dekameronki-kato-bonbonki/mechtanata
/Творчество/Декамеронки-като-бонбонки/Под-секрет	/tvorchestvo/dekameronki-kato-bonbonki/pod-sekret
/Творчество/Декамеронки-като-бонбонки/Божествената	/tvorchestvo/dekameronki-kato-bonbonki/bozhestvenata
/Творчество/Декамеронки-като-бонбонки/Мънистено-герданче	/tvorchestvo/dekameronki-kato-bonbonki/manisteno-gerdanche
/Творчество/Декамеронки-като-бонбонки/Безсмъртният	/tvorchestvo/dekameronki-kato-bonbonki/bezsmartniyat
/Творчество/Добър-ден-народе-мой	/tvorchestvo/dobar-den-narode-moi
/Творчество/Добър-ден-народе-мой/Равносметка	/tvorchestvo/dobar-den-narode-moi/ravnosmetka
/Творчество/Добър-ден-народе-мой/История	/tvorchestvo/dobar-den-narode-moi/istoriya
/Творчество/Добър-ден-народе-мой/Досието	/tvorchestvo/dobar-den-narode-moi/dosieto
/Творчество/Добър-ден-народе-мой/Синовен-зов	/tvorchestvo/dobar-den-narode-moi/sinoven-zov
/Творчество/Добър-ден-народе-мой/Десети-януари	/tvorchestvo/dobar-den-narode-moi/deseti-yanuari
/Творчество/Добър-ден-народе-мой/Апокалипсис	/tvorchestvo/dobar-den-narode-moi/apokalipsis
/Творчество/Добър-ден-народе-мой/Промяната	/tvorchestvo/dobar-den-narode-moi/promyanata
/Творчество/Добър-ден-народе-мой/Майчице-България	/tvorchestvo/dobar-den-narode-moi/maychice-balgariya
/Творчество/Добър-ден-народе-мой/Зла-орис	/tvorchestvo/dobar-den-narode-moi/zla-oris
/Творчество/Добър-ден-народе-мой/Синовна-жалба	/tvorchestvo/dobar-den-narode-moi/sinovna-zhalba
/Творчество/Добър-ден-народе-мой/Изборно	/tvorchestvo/dobar-den-narode-moi/izborno
/Творчество/Добър-ден-народе-мой/Благословената	/tvorchestvo/dobar-den-narode-moi/blagoslovenata
/Творчество/Добър-ден-народе-мой/Житие	/tvorchestvo/dobar-den-narode-moi/zhitie
/Творчество/Добър-ден-народе-мой/Синовно	/tvorchestvo/dobar-den-narode-moi/sinovno
/Творчество/Добър-ден-народе-мой/Потоп	/tvorchestvo/dobar-den-narode-moi/potop
/Творчество/Добър-ден-народе-мой/Време-е	/tvorchestvo/dobar-den-narode-moi/vreme-e
/Творчество/Добър-ден-народе-мой/Господи-помилуй-нас	/tvorchestvo/dobar-den-narode-moi/gospodi-pomilui-nas
/Творчество/Добър-ден-народе-мой/Ставаме-народ	/tvorchestvo/dobar-den-narode-moi/stavame-narod
/Творчество/Добър-ден-народе-мой/Новогодишна-рецепта	/tvorchestvo/dobar-den-narode-moi/novogodishna-recepta
/Творчество/Добър-ден-народе-мой/Pro-domo-sua	/tvorchestvo/dobar-den-narode-moi/pro-domo-sua
/Творчество/Добър-ден-народе-мой/Светая-светих	/tvorchestvo/dobar-den-narode-moi/svetaya-svetih
/Творчество/Добър-ден-народе-мой/На-Вазовия-гроб	/tvorchestvo/dobar-den-narode-moi/na-vazoviya-grob
/Творчество/Добър-ден-народе-мой/Народ	/tvorchestvo/dobar-den-narode-moi/narod
/Творчество/Добър-ден-народе-мой/Аз-казах-вече-на-светът	/tvorchestvo/dobar-den-narode-moi/az-kazah-veche-na-svetat
/Творчество/Добър-ден-народе-мой/До-сетен-час	/tvorchestvo/dobar-den-narode-moi/do-seten-chas
/Творчество/Добър-ден-народе-мой/Селякът	/tvorchestvo/dobar-den-narode-moi/selyakot
/Творчество/Добър-ден-народе-мой/Новият-човек	/tvorchestvo/dobar-den-narode-moi/noviqt-chovek
/Творчество/Добър-ден-народе-мой/Вълци	/tvorchestvo/dobar-den-narode-moi/valci
/Творчество/Добър-ден-народе-мой/Човекът	/tvorchestvo/dobar-den-narode-moi/chovekat
/Творчество/Добър-ден-народе-мой/Пред-буря	/tvorchestvo/dobar-den-narode-moi/pred-burya
/Творчество/Добър-ден-народе-мой/Честване	/tvorchestvo/dobar-den-narode-moi/chestvane
/Творчество/Добър-ден-народе-мой/Защо-не-пишеш	/tvorchestvo/dobar-den-narode-moi/zashto-ne-pishesh
/Творчество/Добър-ден-народе-мой/Защо-мълчим	/tvorchestvo/dobar-den-narode-moi/zashto-malchim
/Творчество/Добър-ден-народе-мой/Небето-с-плам-ме-е-дарило	/tvorchestvo/dobar-den-narode-moi/nebeto-s-plam-me-e-darilo
/Творчество/Добър-ден-народе-мой/Реплика	/tvorchestvo/dobar-den-narode-moi/replika
/Творчество/Добър-ден-народе-мой/Свободата-си-пази	/tvorchestvo/dobar-den-narode-moi/svobodata-si-pazete
/Творчество/Добър-ден-народе-мой/S-O-S	/tvorchestvo/dobar-den-narode-moi/sos
/Творчество/Добър-ден-народе-мой/АЕЦ	/tvorchestvo/dobar-den-narode-moi/aec
/Творчество/Добър-ден-народе-мой/Създание	/tvorchestvo/dobar-den-narode-moi/sazdanie
/Творчество/Добър-ден-народе-мой/Революцийо	/tvorchestvo/dobar-den-narode-moi/revolyuciyo
/Творчество/Добър-ден-народе-мой/Поетът	/tvorchestvo/dobar-den-narode-moi/poetat
/Творчество/Добър-ден-народе-мой/Луд	/tvorchestvo/dobar-den-narode-moi/lud
/Творчество/Добър-ден-народе-мой/Борба	/tvorchestvo/dobar-den-narode-moi/borba
/Творчество/Добър-ден-народе-мой/Житен-клас	/tvorchestvo/dobar-den-narode-moi/zhiten-klas
/Творчество/Добър-ден-народе-мой/Псалмопевци	/tvorchestvo/dobar-den-narode-moi/psalmopevci
/Творчество/Добър-ден-народе-мой/Към-поета	/tvorchestvo/dobar-den-narode-moi/kam-poeta
/Творчество/Добър-ден-народе-мой/Елегия	/tvorchestvo/dobar-den-narode-moi/elegiya
/Творчество/Добър-ден-народе-мой/Месия	/tvorchestvo/dobar-den-narode-moi/mesiya
/Творчество/Добър-ден-народе-мой/In-memoriam	/tvorchestvo/dobar-den-narode-moi/in-memoriam
/Творчество/Добър-ден-народе-мой/Двамата	/tvorchestvo/dobar-den-narode-moi/dvamata
/Творчество/Добър-ден-народе-мой/Непобеденият	/tvorchestvo/dobar-den-narode-moi/nepobedeniyat
/Творчество/Добър-ден-народе-мой/Стоикът	/tvorchestvo/dobar-den-narode-moi/stoikat
/Творчество/Добър-ден-народе-мой/Реквием	/tvorchestvo/dobar-den-narode-moi/rekviem
/Творчество/Добър-ден-народе-мой/Синовна-дружба	/tvorchestvo/dobar-den-narode-moi/sinovna-druzhba
/Творчество/Добър-ден-народе-мой/Безсмъртно	/tvorchestvo/dobar-den-narode-moi/bezsmartno
/Творчество/Добър-ден-народе-мой/Човеколюбецът	/tvorchestvo/dobar-den-narode-moi/chovekolyubecat
/Творчество/Добър-ден-народе-мой/След-Интервю-с-Би-Би-Си	/tvorchestvo/dobar-den-narode-moi/sled-intervyu-s-bbc
/Творчество/Добър-ден-народе-мой/Диктатори	/tvorchestvo/dobar-den-narode-moi/diktatorat
/Творчество/Добър-ден-народе-мой/Заветът-на-Ленин	/tvorchestvo/dobar-den-narode-moi/zavetat-na-lenin
/Творчество/Добър-ден-народе-мой/Сталин	/tvorchestvo/dobar-den-narode-moi/stalin
/Творчество/Добър-ден-народе-мой/На-Хитлера-благодарете	/tvorchestvo/dobar-den-narode-moi/na-hitlera-blagodarete
/Творчество/Добър-ден-народе-мой/На-един-людоед	/tvorchestvo/dobar-den-narode-moi/na-edin-lyudoed
/Творчество/Добър-ден-народе-мой/Проклятие	/tvorchestvo/dobar-den-narode-moi/proklyatie
/Творчество/Добър-ден-народе-мой/Защо-ти-трябваше-Исусе	/tvorchestvo/dobar-den-narode-moi/zashto-ti-tryabvashe-isuse
/Творчество/Добър-ден-народе-мой/Заключеник	/tvorchestvo/dobar-den-narode-moi/zaklyuchenik
/Творчество/Добър-ден-народе-мой/Персин	/tvorchestvo/dobar-den-narode-moi/persin
/Творчество/Добър-ден-народе-мой/Защо	/tvorchestvo/dobar-den-narode-moi/zashto
/Творчество/Добър-ден-народе-мой/На-заточение	/tvorchestvo/dobar-den-narode-moi/na-zatochenie
/Творчество/Добър-ден-народе-мой/Клетва	/tvorchestvo/dobar-den-narode-moi/kletva
/Творчество/Добър-ден-народе-мой/Жалейно	/tvorchestvo/dobar-den-narode-moi/zhaleyno
/Творчество/Добър-ден-народе-мой/Тъмнична-песен	/tvorchestvo/dobar-den-narode-moi/tamnichna-pesen
/Творчество/Добър-ден-народе-мой/Заклинание	/tvorchestvo/dobar-den-narode-moi/zaklinanie
/Творчество/Добър-ден-народе-мой/Акростих	/tvorchestvo/dobar-den-narode-moi/akrostih
/Творчество/Добър-ден-народе-мой/Видение	/tvorchestvo/dobar-den-narode-moi/videnie
/Творчество/Добър-ден-народе-мой/Пролет-в-Персин	/tvorchestvo/dobar-den-narode-moi/prolet-v-persin
/Творчество/Добър-ден-народе-мой/Легенда	/tvorchestvo/dobar-den-narode-moi/legenda
/Творчество/Добър-ден-народе-мой/Повест	/tvorchestvo/dobar-den-narode-moi/povest
/Творчество/Добър-ден-народе-мой/Карцерът	/tvorchestvo/dobar-den-narode-moi/karcerat
/Творчество/Добър-ден-народе-мой/Каторга	/tvorchestvo/dobar-den-narode-moi/katorga
/Творчество/Добър-ден-народе-мой/Колет	/tvorchestvo/dobar-den-narode-moi/kolet
/Творчество/Добър-ден-народе-мой/Робия	/tvorchestvo/dobar-den-narode-moi/robiya
/Творчество/Добър-ден-народе-мой/Затворник	/tvorchestvo/dobar-den-narode-moi/zatvornik
/Творчество/Добър-ден-народе-мой/Утро-в-Персин	/tvorchestvo/dobar-den-narode-moi/utro-v-persin
/Творчество/Добър-ден-народе-мой/Двубой	/tvorchestvo/dobar-den-narode-moi/dvuboi
/Творчество/Добър-ден-народе-мой/В-утринния-час	/tvorchestvo/dobar-den-narode-moi/v-utrinniya-chas
/Творчество/Добър-ден-народе-мой/Майчина-жалба	/tvorchestvo/dobar-den-narode-moi/maychina-zhalba
/Творчество/Добър-ден-народе-мой/Пощенска-картичка	/tvorchestvo/dobar-den-narode-moi/poshtenska-kartichka
/Творчество/Добър-ден-народе-мой/Гълъбчето-бяло	/tvorchestvo/dobar-den-narode-moi/galabcheto-byalo
/Творчество/Добър-ден-народе-мой/Вик-от-каторгата	/tvorchestvo/dobar-den-narode-moi/vik-ot-katorgata
/Творчество/Добър-ден-народе-мой/Нощ-над-Персин	/tvorchestvo/dobar-den-narode-moi/nosht-nad-persin
/Творчество/Добър-ден-народе-мой/Превъдворяване	/tvorchestvo/dobar-den-narode-moi/prevadvoryavane
/Творчество/Добър-ден-народе-мой/Персински-мотиви	/tvorchestvo/dobar-den-narode-moi/persinski-motivi
/Творчество/Добър-ден-народе-мой/Шегобийците-пазете	/tvorchestvo/dobar-den-narode-moi/shegobiicite-pazete
/Творчество/Добър-ден-народе-мой/ОФ-Събрание	/tvorchestvo/dobar-den-narode-moi/of-sabranie
/Творчество/Добър-ден-народе-мой/За-благодарност	/tvorchestvo/dobar-den-narode-moi/za-blagodarnost
/Творчество/Добър-ден-народе-мой/Плюй-и-отмини	/tvorchestvo/dobar-den-narode-moi/plyui-i-otmini
/Творчество/Добър-ден-народе-мой/Земляци	/tvorchestvo/dobar-den-narode-moi/zemlyaci
/Творчество/Добър-ден-народе-мой/Кой-е-днес-на-власт-у-нас	/tvorchestvo/dobar-den-narode-moi/koi-e-dnes-na-vlast-u-nas
/Творчество/Добър-ден-народе-мой/Юбилей	/tvorchestvo/dobar-den-narode-moi/yubilei
/Творчество/Добър-ден-народе-мой/При-почерпка	/tvorchestvo/dobar-den-narode-moi/pri-pocherpka
/Творчество/Добър-ден-народе-мой/Прокълнатият	/tvorchestvo/dobar-den-narode-moi/prokalnatiyat
/Творчество/Добър-ден-народе-мой/Изповед	/tvorchestvo/dobar-den-narode-moi/izpoved
/Творчество/Добър-ден-народе-мой/Tалмудисти	/tvorchestvo/dobar-den-narode-moi/talmudisti
/Творчество/Добър-ден-народе-мой/Все-тези	/tvorchestvo/dobar-den-narode-moi/vse-tezi
/Творчество/Добър-ден-народе-мой/Просъница	/tvorchestvo/dobar-den-narode-moi/prosanica
/Творчество/Добър-ден-народе-мой/Завод	/tvorchestvo/dobar-den-narode-moi/zavod
/Творчество/Добър-ден-народе-мой/Мента	/tvorchestvo/dobar-den-narode-moi/menta
/Творчество/Добър-ден-народе-мой/Уж-сме-правова-държава	/tvorchestvo/dobar-den-narode-moi/uzh-sme-pravova-darzhava
/Творчество/Добър-ден-народе-мой/Родна-картинка	/tvorchestvo/dobar-den-narode-moi/rodna-kartinka
/Творчество/Добър-ден-народе-мой/Мъничка-парлива-китка-от-коприва	/tvorchestvo/dobar-den-narode-moi/manichka-parliva-kitka-ot-kopriva
/Творчество/Добър-ден-народе-мой/Великанът	/tvorchestvo/dobar-den-narode-moi/velikanat
/Творчество/Добър-ден-народе-мой/Първоапостолът	/tvorchestvo/dobar-den-narode-moi/parvoapostolat
/Творчество/Добър-ден-народе-мой/Закрилникът	/tvorchestvo/dobar-den-narode-moi/zakrilnikat
/Творчество/Добър-ден-народе-мой/Републиканецът	/tvorchestvo/dobar-den-narode-moi/republikanecat
/Творчество/Добър-ден-народе-мой/Несломимият	/tvorchestvo/dobar-den-narode-moi/neslomimiyat
/Творчество/Добър-ден-народе-мой/Изгнаникът	/tvorchestvo/dobar-den-narode-moi/izgnanikat
/Творчество/Добър-ден-народе-мой/Железният	/tvorchestvo/dobar-den-narode-moi/zhelezniyat
/Творчество/Добър-ден-народе-мой/Ангелогласният	/tvorchestvo/dobar-den-narode-moi/angeloglasniyat
/Творчество/Добър-ден-народе-мой/Тракийският-орел	/tvorchestvo/dobar-den-narode-moi/trakiyskiyat-orel
/Творчество/Добър-ден-народе-мой/По-пътя	/tvorchestvo/dobar-den-narode-moi/po-patya
/Творчество/Добър-ден-народе-мой/Орач	/tvorchestvo/dobar-den-narode-moi/orach
/Творчество/Добър-ден-народе-мой/Селска-неволя	/tvorchestvo/dobar-den-narode-moi/selska-nevolya
/Творчество/Добър-ден-народе-мой/Април-1925	/tvorchestvo/dobar-den-narode-moi/april-1925
/Творчество/Добър-ден-народе-мой/Приказка	/tvorchestvo/dobar-den-narode-moi/prikazka
/Творчество/Добър-ден-народе-мой/Обикновена-случка	/tvorchestvo/dobar-den-narode-moi/obiknovena-sluchka
/Творчество/Добър-ден-народе-мой/Харамии	/tvorchestvo/dobar-den-narode-moi/haramii
/Творчество/Добър-ден-народе-мой/Певачка	/tvorchestvo/dobar-den-narode-moi/pevachka
/Творчество/Добър-ден-народе-мой/Акрани	/tvorchestvo/dobar-den-narode-moi/akrani
/Творчество/Добър-ден-народе-мой/Химн-на-селските-кооператори	/tvorchestvo/dobar-den-narode-moi/himn-na-selskite-kooperatori
/Творчество/Добър-ден-народе-мой/Шабла-дуранкулак	/tvorchestvo/dobar-den-narode-moi/shabla-durankulak
/Творчество/Избрано	/tvorchestvo/izbrano
/Творчество/Избрано/Изповедно	/tvorchestvo/izbrano/izpovedno
/Творчество/Избрано/Късче-синя-вис	/tvorchestvo/izbrano/kasche-sinya-vis
/Творчество/Избрано/Равносметка	/tvorchestvo/izbrano/ravnosmetka
/Творчество/Избрано/Небето-с-плам-ме-е-дарило	/tvorchestvo/izbrano/nebeto-s-plam-me-e-darilo
/Творчество/Избрано/Пророкуване	/tvorchestvo/izbrano/prorokuvane
/Творчество/Избрано/До-сетен-час	/tvorchestvo/izbrano/do-seten-chas
/Творчество/Избрано/Човекът-е-роден-за-полет	/tvorchestvo/izbrano/chovekat-e-roden-za-polet
/Творчество/Избрано/Всеки-иска-да-векува	/tvorchestvo/izbrano/vseki-iska-da-vekuva
/Творчество/Избрано/Към-приятеля	/tvorchestvo/izbrano/kam-priyatelya
/Творчество/Избрано/Аз-казах-вече-на-светът	/tvorchestvo/izbrano/az-kazah-veche-na-svetat
/Творчество/Избрано/Скръбна-песен	/tvorchestvo/izbrano/skrabna-pesen
/Творчество/Избрано/Pro-domo-sua	/tvorchestvo/izbrano/pro-domo-sua
/Творчество/Избрано/Предсмъртно	/tvorchestvo/izbrano/predsmartno
/Творчество/Избрано/Човекът	/tvorchestvo/izbrano/chovekat
/Творчество/Избрано/Досието	/tvorchestvo/izbrano/dosieto
/Творчество/Избрано/Защо-мълчим	/tvorchestvo/izbrano/zashto-malchim
/Творчество/Избрано/На-Вазовия-гроб	/tvorchestvo/izbrano/na-vazoviya-grob
/Творчество/Избрано/Светая-светих	/tvorchestvo/izbrano/svetaya-svetih
/Творчество/Избрано/Синовен-зов	/tvorchestvo/izbrano/sinoven-zov
/Творчество/Избрано/Господи-помилуй-нас	/tvorchestvo/izbrano/gospodi-pomilui-nas
/Творчество/Избрано/Ставаме-народ	/tvorchestvo/izbrano/stavame-narod
/Творчество/Избрано/Апокалипсис	/tvorchestvo/izbrano/apokalipsis
/Творчество/Избрано/Синовна-жалба	/tvorchestvo/izbrano/sinovna-zhalba
/Творчество/Избрано/Десети-януари	/tvorchestvo/izbrano/deseti-yanuari
/Творчество/Избрано/Април-1925	/tvorchestvo/izbrano/april-1925
/Творчество/Избрано/Заклинание	/tvorchestvo/izbrano/zaklinanie
/Творчество/Избрано/Борба	/tvorchestvo/izbrano/borba
/Творчество/Избрано/S-O-S	/tvorchestvo/izbrano/sos
/Творчество/Избрано/Елегия	/tvorchestvo/izbrano/elegiya
/Творчество/Избрано/Народ	/tvorchestvo/izbrano/narod
/Творчество/Избрано/Революцийо	/tvorchestvo/izbrano/revolyuciyo
/Творчество/Избрано/Пред-буря	/tvorchestvo/izbrano/pred-burya
/Творчество/Избрано/Поетът	/tvorchestvo/izbrano/poetat
/Творчество/Избрано/Към-поета	/tvorchestvo/izbrano/kam-poeta
/Творчество/Избрано/Защо-не-пишеш	/tvorchestvo/izbrano/zashto-ne-pishesh
/Творчество/Избрано/Реплика	/tvorchestvo/izbrano/replika
/Творчество/Избрано/Поети	/tvorchestvo/izbrano/poeti
/Творчество/Избрано/Сбогом	/tvorchestvo/izbrano/sbogom
/Творчество/Избрано/Из-Прощално	/tvorchestvo/izbrano/iz-proshtalno
/Творчество/Избрано/Учителят	/tvorchestvo/izbrano/uchitelyat
/Творчество/Избрано/Заключеник	/tvorchestvo/izbrano/zaklyuchenik
/Творчество/Избрано/Защо	/tvorchestvo/izbrano/zashto
/Творчество/Избрано/Вик-от-каторгата	/tvorchestvo/izbrano/vik-ot-katorgata
/Творчество/Избрано/Персин	/tvorchestvo/izbrano/persin
/Творчество/Избрано/Нощ-над-Персин	/tvorchestvo/izbrano/nosht-nad-persin
/Творчество/Избрано/Каторга	/tvorchestvo/izbrano/katorga
/Творчество/Избрано/Колет	/tvorchestvo/izbrano/kolet
/Творчество/Избрано/Пролет-в-Персин	/tvorchestvo/izbrano/prolet-v-persin
/Творчество/Избрано/Видение	/tvorchestvo/izbrano/videnie
/Творчество/Избрано/Затворник	/tvorchestvo/izbrano/zatvornik
/Творчество/Избрано/На-заточение	/tvorchestvo/izbrano/na-zatochenie
/Творчество/Избрано/Повест	/tvorchestvo/izbrano/povest
/Творчество/Избрано/Робия	/tvorchestvo/izbrano/robiya
/Творчество/Избрано/В-утринния-час	/tvorchestvo/izbrano/v-utrinniya-chas
/Творчество/Избрано/Жени-жени	/tvorchestvo/izbrano/zheni-zheni
/Творчество/Избрано/Вечерна-среща	/tvorchestvo/izbrano/vecherna-sreshta
/Творчество/Избрано/Недей-тъгува	/tvorchestvo/izbrano/nedei-taguva
/Творчество/Избрано/Богатство	/tvorchestvo/izbrano/bogatstvo
/Творчество/Избрано/Майско-утро	/tvorchestvo/izbrano/maisko-utro
/Творчество/Избрано/Жулиета	/tvorchestvo/izbrano/zhulieta
/Творчество/Избрано/Имам-конче-шарколия	/tvorchestvo/izbrano/imam-konche-sharkoliya
/Творчество/Избрано/Благодаря-ти-Мариета	/tvorchestvo/izbrano/blagodarya-ti-marieta
/Творчество/Избрано/Песен	/tvorchestvo/izbrano/pesen
/Творчество/Избрано/Ти-и-аз	/tvorchestvo/izbrano/ti-i-az
/Творчество/Избрано/Мечтаната	/tvorchestvo/izbrano/mechtanata
/Творчество/Избрано/Венец-от-незабравки	/tvorchestvo/izbrano/venec-ot-nezabravki
/Творчество/Избрано/Старост	/tvorchestvo/izbrano/starost
/Творчество/Избрано/Спомен-за-мама	/tvorchestvo/izbrano/spomen-za-mama
/Творчество/Избрано/Приказка-са-мамините-думи	/tvorchestvo/izbrano/prikazka-sa-maminite-dumi
/Творчество/Избрано/Към-село	/tvorchestvo/izbrano/kam-selo
/Творчество/Избрано/Орач	/tvorchestvo/izbrano/orach
/Творчество/Избрано/Зима-в-нашенско	/tvorchestvo/izbrano/zima-v-nashensko
/Творчество/Избрано/Синът	/tvorchestvo/izbrano/sinat
/Творчество/Избрано/Ноктюрно	/tvorchestvo/izbrano/noktyurno
/Творчество/Избрано/Пролетно-опиянение	/tvorchestvo/izbrano/proletno-opiyanenie
/Творчество/Избрано/Селякът	/tvorchestvo/izbrano/selyakot
/Творчество/Избрано/Новият-човек	/tvorchestvo/izbrano/noviqt-chovek
/Творчество/Избрано/Вълци	/tvorchestvo/izbrano/valci
/Творчество/Избрано/По-пътя	/tvorchestvo/izbrano/po-patya
/Творчество/Избрано/Създание	/tvorchestvo/izbrano/sazdanie
/Творчество/Избрано/Честване	/tvorchestvo/izbrano/chestvane
/Творчество/Избрано/Плюй-и-отмини	/tvorchestvo/izbrano/plyui-i-otmini
/Творчество/Избрано/Сказание	/tvorchestvo/izbrano/skazanie
/Творчество/Избрано/Земляци	/tvorchestvo/izbrano/zemlyaci
/Творчество/Избрано/Заветът-на-Ленин	/tvorchestvo/izbrano/zavetat-na-lenin
/Творчество/Избрано/За-благодарност	/tvorchestvo/izbrano/za-blagodarnost
/Творчество/Избрано/Скрита-картинка	/tvorchestvo/izbrano/skrita-kartinka
/Творчество/Избрано/В-трамвая	/tvorchestvo/izbrano/v-tramvaya
/Творчество/Избрано/Псалмопевци	/tvorchestvo/izbrano/psalmopevci
/Творчество/Избрано/Съдбовно	/tvorchestvo/izbrano/sadbovno
/Творчество/Избрано/Налъми	/tvorchestvo/izbrano/nalami
/Творчество/Избрано/Майтап	/tvorchestvo/izbrano/maitap
/Творчество/Избрано/Автори	/tvorchestvo/izbrano/avtori
/Творчество/Избрано/Затвор	/tvorchestvo/izbrano/zatvor
/Творчество/Избрано/Луд	/tvorchestvo/izbrano/lud
/Творчество/Избрано/Възмездие	/tvorchestvo/izbrano/vazmezdie
/Творчество/Избрано/Житен-клас	/tvorchestvo/izbrano/zhiten-klas
/Творчество/Избрано/Девизът	/tvorchestvo/izbrano/devizat
/Творчество/Избрано/Приветствие	/tvorchestvo/izbrano/privetstvie
/Творчество/Избрано/Погребално	/tvorchestvo/izbrano/pogrebalno
/Творчество/Избрано/Шегобийците-пазете	/tvorchestvo/izbrano/shegobiicite-pazete
/Творчество/Избрано/Докато-съм-жив	/tvorchestvo/izbrano/dokato-sam-zhiv
/Творчество/Избрано/С-благодарност	/tvorchestvo/izbrano/s-blagodarnost
/Творчество/Избрано/Жената	/tvorchestvo/izbrano/zhenata
/Творчество/Избрано/Под-секрет	/tvorchestvo/izbrano/pod-sekret
/Творчество/Избрано/Елена	/tvorchestvo/izbrano/elena
/Творчество/Избрано/Молитва	/tvorchestvo/izbrano/molitva
/Творчество/Избрано/Кариера	/tvorchestvo/izbrano/kariera
/Творчество/Избрано/Стара-мъдрост	/tvorchestvo/izbrano/stara-madrost
/Творчество/Избрано/Кончина	/tvorchestvo/izbrano/konchina
/Творчество/Избрано/Войнишка-любов	/tvorchestvo/izbrano/voinishka-lyubov
/Творчество/Избрано/Янка	/tvorchestvo/izbrano/yanka
/Творчество/Избрано/Месия	/tvorchestvo/izbrano/mesiya
/Творчество/Избрано/Човеколюбецът	/tvorchestvo/izbrano/chovekolyubecat
/Творчество/Избрано/Ангелогласният	/tvorchestvo/izbrano/angeloglasniyat
/Творчество/Избрано/След-Интервю-с-Би-Би-Си	/tvorchestvo/izbrano/sled-intervyu-s-bbc
/Творчество/Избрано/Стоикът	/tvorchestvo/izbrano/stoikat
/Творчество/Избрано/В-здрачен-час	/tvorchestvo/izbrano/v-zdrachen-chas
/Творчество/Избрано/Двамата	/tvorchestvo/izbrano/dvamata
/Творчество/Избрано/Достойният	/tvorchestvo/izbrano/dostoyniyat
/Творчество/Избрано/Харамии	/tvorchestvo/izbrano/haramii
/Творчество/Избрано/На-птиците-завиждам-аз	/tvorchestvo/izbrano/na-pticite-zavizhdam-az
/Творчество/Избрано/Карцерът	/tvorchestvo/izbrano/karcerat
/Творчество/Избрано/Село	/tvorchestvo/izbrano/selo
/Творчество/Избрано/Клетва	/tvorchestvo/izbrano/kletva
/Творчество/Избрано/Гълъби	/tvorchestvo/izbrano/galabi
/Творчество/Избрано/Яворови-дни	/tvorchestvo/izbrano/yavorovi-dni
/Творчество/Избрано/На-един-людоед	/tvorchestvo/izbrano/na-edin-lyudoed
/Творчество/Избрано/Проклятие	/tvorchestvo/izbrano/proklyatie
/Творчество/Избрано/Пощенска-картичка	/tvorchestvo/izbrano/poshtenska-kartichka
/Творчество/Избрано/Целебна-сила	/tvorchestvo/izbrano/celebna-sila
/Творчество/Избрано/Блага-рана	/tvorchestvo/izbrano/blaga-rana
/Творчество/Избрано/Божествената	/tvorchestvo/izbrano/bozhestvenata
/Творчество/Избрано/Великанът	/tvorchestvo/izbrano/velikanat
/Творчество/Избрано/Несломимият	/tvorchestvo/izbrano/neslomimiyat
/Творчество/Избрано/Първоапостолът	/tvorchestvo/izbrano/parvoapostolat
/Творчество/Избрано/Закрилникът	/tvorchestvo/izbrano/zakrilnikat
/Творчество/Избрано/В-бащиния-дом	/tvorchestvo/izbrano/v-bashtiniya-dom
/Творчество/Избрано/Безсмъртният	/tvorchestvo/izbrano/bezsmartniyat
/Творчество/Родна-земя	/tvorchestvo/rodna-zemya
/Творчество/Родна-земя/Пролетен-химн	/tvorchestvo/rodna-zemya/proleten-himn
/Творчество/Родна-земя/Конници	/tvorchestvo/rodna-zemya/konnici
/Творчество/Родна-земя/Пролетна-песен	/tvorchestvo/rodna-zemya/proletna-pesen
/Творчество/Родна-земя/Пролет	/tvorchestvo/rodna-zemya/prolet
/Творчество/Родна-земя/Син	/tvorchestvo/rodna-zemya/sin
/Творчество/Родна-земя/Утринна-песен	/tvorchestvo/rodna-zemya/utrinna-pesen
/Творчество/Родна-земя/Коситба	/tvorchestvo/rodna-zemya/kositba
/Творчество/Родна-земя/Утро	/tvorchestvo/rodna-zemya/utro
/Творчество/Родна-земя/Лято	/tvorchestvo/rodna-zemya/lyato
/Творчество/Родна-земя/Акрани	/tvorchestvo/rodna-zemya/akrani
/Творчество/Родна-земя/Орач	/tvorchestvo/rodna-zemya/orach
/Творчество/Родна-земя/Робство	/tvorchestvo/rodna-zemya/robstvo
/Творчество/Родна-земя/Зима	/tvorchestvo/rodna-zemya/zima
/Творчество/Родна-земя/Село	/tvorchestvo/rodna-zemya/selo
/Творчество/Родна-земя/Химн-на-селските-кооператори	/tvorchestvo/rodna-zemya/himn-na-selskite-kooperatori
/Творчество/Родна-земя/Радост	/tvorchestvo/rodna-zemya/radost
/Творчество/Родна-земя/Селяк	/tvorchestvo/rodna-zemya/selyak
/Творчество/Родна-земя/Суша	/tvorchestvo/rodna-zemya/susha
/Творчество/Родна-земя/Честита-нова-година	/tvorchestvo/rodna-zemya/chestita-nova-godina
/Творчество/Родна-земя/Стария-златар	/tvorchestvo/rodna-zemya/stariya-zlatar
/Творчество/Родна-земя/Из-Седенкарски-нощи	/tvorchestvo/rodna-zemya/iz-sedenkarski-noshti
/Творчество/Родна-земя/Певачка	/tvorchestvo/rodna-zemya/pevachka
/Творчество/Родна-земя/Обикновена-случка	/tvorchestvo/rodna-zemya/obiknovena-sluchka
/Творчество/Родна-земя/Селяни	/tvorchestvo/rodna-zemya/selyani
/Творчество/Родна-земя/Освобождение	/tvorchestvo/rodna-zemya/osvobozhdenie
/Творчество/Родна-земя/Посвещение	/tvorchestvo/rodna-zemya/posveshtenie
/Творчество/Родна-земя/Приказка	/tvorchestvo/rodna-zemya/prikazka
/Творчество/Родна-земя/Страната-на-ухаещите-рози	/tvorchestvo/rodna-zemya/stranata-na-uhaeshtite-rozi
/Творчество/Родна-земя/Тъжна-песен	/tvorchestvo/rodna-zemya/tazhna-pesen
/Творчество/Родна-земя/Аграрци	/tvorchestvo/rodna-zemya/agrarci
/Творчество/Родна-земя/Харамии	/tvorchestvo/rodna-zemya/haramii
/Творчество/Родна-земя/Из-Хайдушки-песни	/tvorchestvo/rodna-zemya/iz-haydushki-pesni
/Творчество/Родна-земя/Из-Песни-за-Чехословакия-Реквием	/tvorchestvo/rodna-zemya/iz-pesni-za-chehloslovakiya
/Творчество/Родна-земя/Призив	/tvorchestvo/rodna-zemya/priziv
/Творчество/Родна-земя/Кръв	/tvorchestvo/rodna-zemya/krav
/Творчество/Родна-земя/Из-Бунтовникът	/tvorchestvo/rodna-zemya/iz-buntovnikat
/Търсене	/tarsene
/Галерия	/galeriya
/Видео	/
/Видео/Срещи-ЛИК	/video/sreshti-lik
/Видео/90-години-не-стигат	/video/90-godini-ne-stigat
/Видео/В-памет-на-Йосиф-Петров	/video/v-pamet-na-yosif-petrov
/Видео/Не-мога-да-мълча	/video/ne-moga-da-malcha
/Видео/Фоклорен-фестивал-Йосиф-Петров	/video/folkloren-festival-yosif-petrov
/Интервюта	/presa/na-balkanite-e-neobhodim-ne-nacionalizam-a-tarpimost
/Статии-и-спомени	/
/Статии-и-спомени/Мигове-в-градинката-на-баба-Пена	/za-yosif-petrov/migove-v-gradinkata-na-baba-pena
/Контакти	/kontakt
/interview.php	/presa/na-balkanite-e-neobhodim-ne-nacionalizam-a-tarpimost
/search.php	/tarsene
/favicon.ico	/images/favicon/favicon.ico
/resources/img/layout/favicon/favicon.ico	/images/favicon/favicon.ico
/images/yosif-petrov-icon.jpg	/images/favicon/favicon.png
/images/yosif-petrov-icon.ico	/images/favicon/favicon.ico
/resources/img/layout/favicon/favicon.ico	/images/favicon/favicon.ico
/resources/img/layout/favicon/favicon.png	/images/favicon/favicon.png
/apple-touch-icon-120x120-precomposed.png	/images/favicon/apple-touch-icon.png
/resources/img/layout/favicon/apple-touch-icon.png	/images/favicon/apple-touch-icon.png
/apple-touch-icon-120x120.png	/images/favicon/apple-touch-icon.png
/images/covers/Босилкова-китка-1946.jpg	/attachments/Book/4/bosilkova-kitka-1946.jpg
/resources/img/content/covers/bosilkova-kitka-1946.jpg	/attachments/Book/4/bosilkova-kitka-1946.jpg
/images/covers/Декамеронки-като-бонбонки-1999.jpg	/attachments/Book/11/dekameronki-kato-bonbonki-1999.jpg
/resources/img/content/covers/dekameronki-kato-bonbonki-1999.jpg	/attachments/Book/11/dekameronki-kato-bonbonki-1999.jpg
/images/covers/Добър-ден-народе-мой-2003.jpg	/attachments/Book/12/dobar-den-narode-moi-2003.jpg
/resources/img/content/covers/dobar-den-narode-moi-2003.jpg	/attachments/Book/12/dobar-den-narode-moi-2003.jpg
/images/covers/Избрано-2005.jpg	/attachments/Book/13/izbrano-2005.jpg
/resources/img/content/covers/izbrano-2005.jpg	/attachments/Book/13/izbrano-2005.jpg
/images/covers/Разпилени-пъстроцветия-1991.jpg	/attachments/Book/8/razpileni-pastrotsvetiya-1991.jpg
/resources/img/content/covers/razpileni-pastrotsvetiya-1991.jpg	/attachments/Book/8/razpileni-pastrotsvetiya-1991.jpg
/images/covers/Родна-земя-1939.jpg	/attachments/Book/1/rodna-zemya-1939.jpg
/resources/img/content/covers/rodna-zemya-1939.jpg	/attachments/Book/1/rodna-zemya-1939.jpg
/images/covers/Селски-и-войнишки-хуморески-1945.jpg	/attachments/Book/3/selski-i-voinishki-humoreski-1945.jpg
/resources/img/content/covers/selski-i-voinishki-humoreski-1945.jpg	/attachments/Book/3/selski-i-voinishki-humoreski-1945.jpg
/images/covers/Смях-и-жлъч-1993.jpg	/attachments/Book/10/smyah-i-zhlach-1993.jpg
/resources/img/content/covers/smyah-i-zhlach-1993.jpg	/attachments/Book/10/smyah-i-zhlach-1993.jpg
/images/covers/Ти-ли-ме-повика-мое-родно-село-1992.jpg	/attachments/Book/9/ti-li-me-povika-moe-rodno-selo-1992.jpg
/resources/img/content/covers/ti-li-me-povika-moe-rodno-selo-1992.jpg	/attachments/Book/9/ti-li-me-povika-moe-rodno-selo-1992.jpg
/images/covers/Вик-от-каторгата-1989.jpg	/attachments/Book/7/vik-ot-katorgata-1989.jpg
/resources/img/content/covers/vik-ot-katorgata-1989.jpg	/attachments/Book/7/vik-ot-katorgata-1989.jpg
/videos/90-godini-ne-stigat.jpg	/attachments/Video/2/90-godini-ne-stigat.jpg
/resources/videos/90-godini-ne-stigat.jpg	/attachments/Video/2/90-godini-ne-stigat.jpg
/videos/90-godini-ne-stigat.mp4	/attachments/Video/2/90-godini-ne-stigat.mp4
/resources/videos/90-godini-ne-stigat.mp4	/attachments/Video/2/90-godini-ne-stigat.mp4
/videos/90-godini-ne-stigat.webm	/attachments/Video/2/90-godini-ne-stigat.webm
/resources/videos/90-godini-ne-stigat.webm	/attachments/Video/2/90-godini-ne-stigat.webm
/videos/Ne-moga-da-mulcha.jpg	/attachments/Video/4/ne-moga-da-malcha.jpg
/resources/videos/ne-moga-da-malcha.jpg	/attachments/Video/4/ne-moga-da-malcha.jpg
/videos/Ne-moga-da-mulcha.mp4	/attachments/Video/4/ne-moga-da-malcha.mp4
/resources/videos/ne-moga-da-malcha.mp4	/attachments/Video/4/ne-moga-da-malcha.mp4
/videos/Ne-moga-da-mulcha.webm	/attachments/Video/4/ne-moga-da-malcha.webm
/resources/videos/ne-moga-da-malcha.webm	/attachments/Video/4/ne-moga-da-malcha.webm
/videos/Purvo-folkloren-vestival-Yosif-Petrov-2019.jpg	/attachments/Video/5/folkloren-festival-yosif-petrov.jpg
/resources/videos/folkloren-festival-yosif-petrov.jpg	/attachments/Video/5/folkloren-festival-yosif-petrov.jpg
/videos/Purvo-folkloren-vestival-Yosif-Petrov-2019.mp4	/attachments/Video/5/folkloren-festival-yosif-petrov.mp4
/resources/videos/folkloren-festival-yosif-petrov.mp4	/attachments/Video/5/folkloren-festival-yosif-petrov.mp4
/videos/Purvo-folkloren-vestival-Yosif-Petrov-2019.webm	/attachments/Video/5/folkloren-festival-yosif-petrov.webm
/resources/videos/folkloren-festival-yosif-petrov.webm	/attachments/Video/5/folkloren-festival-yosif-petrov.webm
/videos/Sreshti-LIK.jpg	/attachments/Video/1/sreshti-lik.jpg
/resources/videos/sreshti-lik.jpg	/attachments/Video/1/sreshti-lik.jpg
/videos/Sreshti-LIK.mp4	/attachments/Video/1/sreshti-lik.mp4
/resources/videos/sreshti-lik.mp4	/attachments/Video/1/sreshti-lik.mp4
/videos/Sreshti-LIK.webm	/attachments/Video/1/sreshti-lik.webm
/resources/videos/sreshti-lik.webm	/attachments/Video/1/sreshti-lik.webm
/videos/V-pamet-na-Yosif-Petrov.jpg	/attachments/Video/3/v-pamet-na-yosif-petrov.jpg
/resources/videos/v-pamet-na-yosif-petrov.jpg	/attachments/Video/3/v-pamet-na-yosif-petrov.jpg
/videos/V-pamet-na-Yosif-Petrov.mp4	/attachments/Video/3/v-pamet-na-yosif-petrov.mp4
/resources/videos/v-pamet-na-yosif-petrov.mp4	/attachments/Video/3/v-pamet-na-yosif-petrov.mp4
/videos/V-pamet-na-Yosif-Petrov.webm	/attachments/Video/3/v-pamet-na-yosif-petrov.webm
/resources/videos/v-pamet-na-yosif-petrov.webm	/attachments/Video/3/v-pamet-na-yosif-petrov.webm